111111
1P0E11
111111
100111
1011C1
111111
