1111111111111111111111111111111111111111111
1111100000000100000000000000000000000000001
1P0E100000000100000000000000000000000000001
1100000000000100000000000000000000000000001
1011C10000000100000000000000000000000000001
1111111111111111111111111111111111111111111
