111111111
1P1100001
1C0010011
111011001
111E11111
1C0000111
111111111
