11111111
1P000001
1C001001
100000C1
10010001
1C000001
10000E01
11111111
