1111111111
1P000000C1
1000100001
1C00010001
1000000001
100C000001
1000100001
1000000E01
1C00000001
1111111111
