111111111111111
1P0000000000001
1000010000000C1
100000000100001
1C0000000000001
100000C00000001
1000010000000001
10000000000C0001
1000000100000001
100C000000000001
1000000000000E01
1000000000010001
100000C000000001
1000000000000001
111111111111111
