111111111111111
1P0001000000001
111010111101101
1C00100010000C1
101111011011111
10000001C000001
1011101111101C1
10001C000010001
111010111010111
1C0010000100001
101110111110111
100000000010001
111011101011101
1E0000C00000C01
111111111111111
