111111111111111
111000100P00001
1E10000P0000001
1000Cp000000001
111111111111111