111111111111111
111000100P00001
1E1000000000C01
1000C0000C00001
111111111111111